"app_id";"review_score";"review_score_desc";"total_positive";"total_negative";"total_reviews"
10;9;"Overwhelmingly Positive";19908;753;20661
20;8;"Very Positive";1889;385;2274
30;8;"Very Positive";1169;169;1338
40;8;"Very Positive";548;131;679
50;9;"Overwhelmingly Positive";4047;192;4239
60;8;"Very Positive";1420;284;1704
70;9;"Overwhelmingly Positive";18643;735;19378
80;8;"Very Positive";3777;420;4197
100;8;"Very Positive";293;22;315
130;8;"Very Positive";2897;311;3208
220;9;"Overwhelmingly Positive";34040;1123;35163
240;9;"Overwhelmingly Positive";24541;1192;25733
280;6;"Mostly Positive";2535;971;3506
300;8;"Very Positive";3995;472;4467
320;8;"Very Positive";2178;317;2495
340;8;"Very Positive";2639;418;3057
360;6;"Mostly Positive";684;230;914
380;8;"Very Positive";4391;255;4646
400;9;"Overwhelmingly Positive";30233;452;30685
420;9;"Overwhelmingly Positive";7486;317;7803
440;8;"Very Positive";5318;413;5731
500;8;"Very Positive";8025;469;8494
550;9;"Overwhelmingly Positive";85465;2697;88162
570;8;"Very Positive";5506;653;6159
620;9;"Overwhelmingly Positive";74754;861;75615
630;8;"Very Positive";123;7;130
660;0;"1 user reviews";1;0;1
730;8;"Very Positive";815676;110706;926382
1002;6;"Mostly Positive";18;5;23
1200;8;"Very Positive";503;86;589
1230;8;"Very Positive";53;9;62
1250;9;"Overwhelmingly Positive";18679;710;19389
1256;7;"Positive";21;3;24
1257;7;"Positive";27;2;29
1280;8;"Very Positive";549;58;607
1300;8;"Very Positive";206;34;240
1313;8;"Very Positive";56;14;70
1500;6;"Mostly Positive";276;79;355
1510;8;"Very Positive";997;105;1102
1520;8;"Very Positive";1429;214;1643
1530;8;"Very Positive";208;31;239
1600;6;"Mostly Positive";118;44;162
1610;8;"Very Positive";115;20;135
1630;6;"Mostly Positive";192;53;245
1640;6;"Mostly Positive";250;99;349
1670;5;"Mixed";70;47;117
1690;5;"Mixed";158;73;231
1700;8;"Very Positive";376;74;450
1840;8;"Very Positive";189;13;202
1900;5;"Mixed";153;109;262
1930;5;"Mixed";712;309;1021
2100;8;"Very Positive";2303;230;2533
2130;0;"5 user reviews";5;0;5
2200;9;"Overwhelmingly Positive";1017;50;1067
2210;8;"Very Positive";564;118;682
2270;8;"Very Positive";1221;74;1295
2280;8;"Very Positive";4454;246;4700
2290;8;"Very Positive";452;78;530
2300;8;"Very Positive";2200;168;2368
2310;9;"Overwhelmingly Positive";2584;130;2714
2320;8;"Very Positive";1181;103;1284
2330;8;"Very Positive";60;14;74
2340;5;"Mixed";38;38;76
2350;6;"Mostly Positive";83;23;106
2360;8;"Very Positive";220;31;251
2370;6;"Mostly Positive";56;17;73
2390;8;"Very Positive";356;24;380
2400;8;"Very Positive";1514;266;1780
2420;5;"Mixed";162;90;252
2450;6;"Mostly Positive";330;118;448
2500;6;"Mostly Positive";355;103;458
2520;5;"Mixed";29;27;56
2525;0;"2 user reviews";1;1;2
2540;5;"Mixed";63;54;117
2545;0;"2 user reviews";0;2;2
2550;0;"2 user reviews";0;2;2
2570;2;"Very Negative";7;71;78
2590;5;"Mixed";221;155;376
2600;8;"Very Positive";5672;300;5972
2610;8;"Very Positive";531;73;604
2620;8;"Very Positive";1197;71;1268
2630;8;"Very Positive";1681;151;1832
2640;8;"Very Positive";404;55;459
2690;0;"1 user reviews";1;0;1
2700;8;"Very Positive";2442;280;2722
2710;8;"Very Positive";122;22;144
2720;7;"Positive";13;1;14
2760;8;"Very Positive";183;8;191
2780;6;"Mostly Positive";82;33;115
2790;0;"1 user reviews";1;0;1
2800;6;"Mostly Positive";107;31;138
2810;5;"Mixed";132;66;198
2820;8;"Very Positive";762;136;898
2840;5;"Mixed";76;34;110
2850;6;"Mostly Positive";21;9;30
2870;4;"Mostly Negative";1195;2135;3330
2900;6;"Mostly Positive";63;18;81
2910;8;"Very Positive";125;27;152
2920;6;"Mostly Positive";32;11;43
2930;0;"1 user reviews";1;0;1
2990;8;"Very Positive";1632;117;1749
3000;6;"Mostly Positive";33;12;45
3010;6;"Mostly Positive";87;26;113
3020;6;"Mostly Positive";347;119;466
3050;6;"Mostly Positive";51;15;66
3130;6;"Mostly Positive";122;32;154
3150;0;"2 user reviews";1;1;2
3160;0;"3 user reviews";3;0;3
3170;8;"Very Positive";205;27;232
3200;7;"Positive";41;3;44
3220;5;"Mixed";37;40;77
3230;4;"Mostly Negative";20;62;82
3260;5;"Mixed";129;104;233
3270;5;"Mixed";123;61;184
3300;8;"Very Positive";167;10;177
3310;8;"Very Positive";242;19;261
3320;9;"Overwhelmingly Positive";1504;50;1554
3322;0;"1 user reviews";1;0;1
3330;8;"Very Positive";370;39;409
3340;6;"Mostly Positive";30;9;39
3350;8;"Very Positive";64;11;75
3360;7;"Positive";33;2;35
3370;7;"Positive";37;3;40
3380;8;"Very Positive";72;5;77
3390;8;"Very Positive";266;11;277
3400;7;"Positive";28;2;30
3410;6;"Mostly Positive";66;27;93
3420;7;"Positive";12;1;13
3430;8;"Very Positive";53;2;55
3450;8;"Very Positive";104;26;130
3460;0;"9 user reviews";9;0;9
3470;8;"Very Positive";69;3;72
3480;9;"Overwhelmingly Positive";1308;48;1356
3490;7;"Positive";11;2;13
3500;5;"Mixed";9;4;13
3510;7;"Positive";25;6;31
3520;6;"Mostly Positive";13;4;17
3530;7;"Positive";30;5;35
3540;8;"Very Positive";379;23;402
3560;8;"Very Positive";122;24;146
3570;6;"Mostly Positive";8;3;11
3580;7;"Positive";18;2;20
3590;9;"Overwhelmingly Positive";11630;325;11955
3600;6;"Mostly Positive";43;13;56
3610;7;"Positive";12;2;14
3620;8;"Very Positive";286;16;302
3630;7;"Positive";31;3;34
3700;6;"Mostly Positive";485;202;687
3710;8;"Very Positive";464;64;528
3720;9;"Overwhelmingly Positive";1795;85;1880
3730;8;"Very Positive";1008;142;1150
3800;8;"Very Positive";183;44;227
3810;6;"Mostly Positive";206;77;283
3820;5;"Mixed";122;72;194
3830;9;"Overwhelmingly Positive";4314;163;4477
3838;0;"3 user reviews";3;0;3
3839;0;"3 user reviews";3;0;3
3900;8;"Very Positive";973;73;1046
3910;8;"Very Positive";1862;164;2026
3920;8;"Very Positive";2345;138;2483
3960;5;"Mixed";42;43;85
3970;0;"4 user reviews";4;0;4
3980;6;"Mostly Positive";187;73;260
3990;8;"Very Positive";102;10;112
4000;9;"Overwhelmingly Positive";256769;8925;265694
4100;5;"Mixed";5;5;10
4230;7;"Positive";29;4;33
4290;0;"1 user reviews";1;0;1
4300;6;"Mostly Positive";17;5;22
4320;0;"4 user reviews";2;2;4
4420;5;"Mixed";25;30;55
4460;5;"Mixed";38;25;63
4470;5;"Mixed";20;10;30
4500;8;"Very Positive";5827;331;6158
4520;5;"Mixed";66;30;96
4530;5;"Mixed";48;24;72
4540;8;"Very Positive";615;110;725
4550;8;"Very Positive";873;66;939
4560;8;"Very Positive";1911;135;2046
4570;9;"Overwhelmingly Positive";2163;103;2266
4580;9;"Overwhelmingly Positive";2257;82;2339
4700;9;"Overwhelmingly Positive";8230;383;8613
4720;8;"Very Positive";726;119;845
4720;8;"Very Positive";726;120;846
4760;8;"Very Positive";5778;345;6123
4770;5;"Mixed";235;105;340
4780;8;"Very Positive";414;14;428
4800;8;"Very Positive";71;12;83
4830;7;"Positive";35;0;35
4850;8;"Very Positive";369;50;419
4856;0;"1 user reviews";0;1;1
4870;8;"Very Positive";50;12;62
4880;6;"Mostly Positive";66;24;90
4890;5;"Mixed";105;52;157
4900;8;"Very Positive";64;8;72
4920;8;"Very Positive";3913;640;4553
6000;8;"Very Positive";5335;281;5616
6010;8;"Very Positive";502;29;531
6020;9;"Overwhelmingly Positive";4819;240;5059
6030;8;"Very Positive";1650;165;1815
6040;8;"Very Positive";449;44;493
6060;8;"Very Positive";24929;1573;26502
6080;8;"Very Positive";314;21;335
6090;8;"Very Positive";104;7;111
6100;7;"Positive";27;6;33
6120;8;"Very Positive";482;85;567
6200;8;"Very Positive";648;86;734
6210;6;"Mostly Positive";58;23;81
6220;8;"Very Positive";687;70;757
6250;8;"Very Positive";275;68;343
6260;0;"1 user reviews";1;0;1
6270;5;"Mixed";31;43;74
6300;8;"Very Positive";455;89;544
6310;8;"Very Positive";863;80;943
6340;0;"3 user reviews";3;0;3
6370;0;"4 user reviews";4;0;4
6400;8;"Very Positive";57;9;66
6420;8;"Very Positive";358;56;414
6510;6;"Mostly Positive";271;96;367
6550;5;"Mixed";455;504;959
6570;5;"Mixed";27;26;53
6600;5;"Mixed";27;29;56
6800;8;"Very Positive";629;88;717
6810;8;"Very Positive";168;35;203
6830;8;"Very Positive";544;126;670
6840;5;"Mixed";129;120;249
6850;8;"Very Positive";658;147;805
6860;8;"Very Positive";3654;235;3889
6870;6;"Mostly Positive";188;69;257
6880;5;"Mixed";753;450;1203
6900;5;"Mixed";574;313;887
6910;9;"Overwhelmingly Positive";5622;267;5889
6920;5;"Mixed";549;376;925
6980;8;"Very Positive";856;176;1032
7000;8;"Very Positive";845;127;972
7010;6;"Mostly Positive";150;52;202
7020;8;"Very Positive";157;9;166
7060;5;"Mixed";7;4;11
7110;6;"Mostly Positive";760;273;1033
7200;8;"Very Positive";599;39;638
7210;5;"Mixed";119;64;183
7220;5;"Mixed";34;39;73
7260;5;"Mixed";33;30;63
7340;0;"9 user reviews";7;2;9
7500;7;"Positive";24;0;24
7510;5;"Mixed";254;232;486
7520;5;"Mixed";934;868;1802
7530;4;"Mostly Negative";37;58;95
7600;5;"Mixed";721;337;1058
7610;8;"Very Positive";395;95;490
7620;8;"Very Positive";496;62;558
7650;8;"Very Positive";299;23;322
7660;8;"Very Positive";353;44;397
7670;8;"Very Positive";9060;587;9647
7730;5;"Mixed";36;32;68
7760;9;"Overwhelmingly Positive";1666;55;1721
7770;5;"Mixed";78;87;165
7800;7;"Positive";25;2;27
7830;8;"Very Positive";735;138;873
7840;5;"Mixed";14;16;30
7850;8;"Very Positive";91;5;96
7860;5;"Mixed";234;101;335
7870;0;"8 user reviews";8;0;8
7880;0;"1 user reviews";1;0;1
7910;0;"1 user reviews";1;0;1
7940;8;"Very Positive";5268;494;5762
7980;0;"2 user reviews";1;1;2
7990;0;"2 user reviews";1;1;2
8000;8;"Very Positive";1044;254;1298
8040;7;"Positive";12;1;13
8060;7;"Positive";35;7;42
8080;5;"Mixed";427;304;731
8100;5;"Mixed";45;57;102
8140;6;"Mostly Positive";794;302;1096
8160;5;"Mixed";15;12;27
8170;5;"Mixed";639;362;1001
8190;8;"Very Positive";14693;1234;15927
8200;8;"Very Positive";216;26;242
8210;7;"Positive";30;1;31
8220;7;"Positive";22;2;24
8230;0;"9 user reviews";9;0;9
8240;7;"Positive";26;1;27
8250;7;"Positive";22;0;22
8260;8;"Very Positive";61;5;66
8270;7;"Positive";18;4;22
8280;7;"Positive";19;1;20
8290;7;"Positive";23;0;23
8300;7;"Positive";16;2;18
8310;5;"Mixed";35;20;55
8320;5;"Mixed";18;8;26
8330;5;"Mixed";24;16;40
8340;8;"Very Positive";176;10;186
8350;7;"Positive";9;2;11
8360;0;"8 user reviews";7;1;8
8370;0;"8 user reviews";7;1;8
8380;0;"7 user reviews";6;1;7
8400;8;"Very Positive";490;47;537
8500;8;"Very Positive";3572;751;4323
8600;8;"Very Positive";362;38;400
8660;7;"Positive";21;2;23
8690;0;"4 user reviews";3;1;4
8790;8;"Very Positive";89;6;95
8800;9;"Overwhelmingly Positive";1291;48;1339
8840;0;"3 user reviews";2;1;3
8850;8;"Very Positive";3871;521;4392
8870;8;"Very Positive";32559;2106;34665
8880;5;"Mixed";159;103;262
8890;8;"Very Positive";101;15;116
8930;9;"Overwhelmingly Positive";59911;2500;62411
8970;5;"Mixed";21;11;32
8980;8;"Very Positive";9468;680;10148
8990;8;"Very Positive";172;34;206
9000;8;"Very Positive";177;28;205
9010;8;"Very Positive";2028;187;2215
9030;8;"Very Positive";124;12;136
9040;8;"Very Positive";183;13;196
9050;8;"Very Positive";2087;276;2363
9060;6;"Mostly Positive";167;44;211
9070;8;"Very Positive";255;40;295
9160;6;"Mostly Positive";218;59;277
9180;8;"Very Positive";704;46;750
9200;6;"Mostly Positive";3714;1463;5177
9310;8;"Very Positive";413;47;460
9340;8;"Very Positive";268;31;299
9350;8;"Very Positive";559;82;641
9400;0;"5 user reviews";3;2;5
9420;9;"Overwhelmingly Positive";2949;103;3052
9450;9;"Overwhelmingly Positive";3533;182;3715
9460;5;"Mixed";195;116;311
9480;6;"Mostly Positive";3476;1040;4516
9500;5;"Mixed";63;34;97
9710;5;"Mixed";17;24;41
9730;4;"Mostly Negative";35;62;97
9740;7;"Positive";26;4;30
9760;6;"Mostly Positive";92;25;117
9800;5;"Mixed";170;73;243
9850;5;"Mixed";25;21;46
9860;8;"Very Positive";163;12;175
9870;8;"Very Positive";955;65;1020
9880;5;"Mixed";82;62;144
9900;6;"Mostly Positive";460;161;621
9908;5;"Mixed";20;10;30
9940;8;"Very Positive";427;96;523
9960;5;"Mixed";7;8;15
9970;4;"Mostly Negative";4;15;19
9980;5;"Mixed";29;14;43
9990;5;"Mixed";27;40;67
10000;0;"8 user reviews";8;0;8
10080;0;"9 user reviews";9;0;9
10090;8;"Very Positive";19096;1210;20306
10100;8;"Very Positive";96;24;120
10110;8;"Very Positive";119;27;146
10120;5;"Mixed";10;15;25
10130;6;"Mostly Positive";284;106;390
10140;5;"Mixed";44;24;68
10150;6;"Mostly Positive";1803;600;2403
10170;7;"Positive";32;1;33
10180;8;"Very Positive";8537;1002;9539
10190;8;"Very Positive";1487;131;1618
10195;5;"Mixed";26;18;44
10196;5;"Mixed";15;19;34
10220;4;"Mostly Negative";239;538;777
10230;4;"Mostly Negative";19;47;66
10240;5;"Mixed";9;6;15
10250;5;"Mixed";10;13;23
10260;0;"9 user reviews";4;5;9
10270;5;"Mixed";108;100;208
10430;8;"Very Positive";41;9;50
10460;5;"Mixed";30;27;57
10500;8;"Very Positive";5823;785;6608
10540;0;"1 user reviews";1;0;1
10600;7;"Positive";36;4;40
10604;7;"Positive";32;8;40
10606;5;"Mixed";36;26;62
10607;6;"Mostly Positive";42;13;55
10608;7;"Positive";16;1;17
10650;0;"5 user reviews";3;2;5
10680;8;"Very Positive";3894;550;4444
10690;0;"2 user reviews";2;0;2
10695;5;"Mixed";14;7;21
10697;6;"Mostly Positive";12;4;16
11020;8;"Very Positive";45;7;52
11040;5;"Mixed";69;30;99
11050;5;"Mixed";46;23;69
11060;0;"1 user reviews";0;1;1
11130;2;"Very Negative";9;58;67
11140;6;"Mostly Positive";104;42;146
11150;5;"Mixed";64;45;109
11170;7;"Positive";14;3;17
11180;4;"Mostly Negative";29;66;95
11190;6;"Mostly Positive";173;63;236
11200;5;"Mixed";134;90;224
11230;5;"Mixed";78;39;117
11240;5;"Mixed";173;147;320
11250;0;"6 user reviews";4;2;6
11260;5;"Mixed";38;43;81
11280;8;"Very Positive";381;36;417
11330;8;"Very Positive";223;51;274
11340;6;"Mostly Positive";170;56;226
11360;6;"Mostly Positive";149;58;207
11370;5;"Mixed";68;58;126
11390;5;"Mixed";204;173;377
11420;8;"Very Positive";140;13;153
11440;7;"Positive";26;2;28
11450;8;"Very Positive";1313;130;1443
11480;6;"Mostly Positive";121;31;152
11500;0;"2 user reviews";1;1;2
11550;7;"Positive";15;0;15
11560;5;"Mixed";23;16;39
11590;5;"Mixed";69;100;169
11610;5;"Mixed";12;15;27
11900;6;"Mostly Positive";33;9;42
11920;6;"Mostly Positive";9;3;12
12100;8;"Very Positive";2234;409;2643
12110;8;"Very Positive";4543;541;5084
12120;8;"Very Positive";12482;1752;14234
12130;5;"Mixed";490;261;751
12140;8;"Very Positive";2688;343;3031
12150;8;"Very Positive";1686;118;1804
12170;6;"Mostly Positive";94;27;121
12180;8;"Very Positive";78;11;89
12190;0;"3 user reviews";3;0;3
12200;6;"Mostly Positive";4701;1179;5880
12210;5;"Mixed";15294;8454;23748
12240;8;"Very Positive";4544;541;5085
12250;7;"Positive";37;1;38
12310;6;"Mostly Positive";34;12;46
12320;6;"Mostly Positive";550;173;723
12330;8;"Very Positive";201;48;249
12340;5;"Mixed";28;17;45
12360;8;"Very Positive";697;171;868
12370;7;"Positive";27;4;31
12380;0;"1 user reviews";1;0;1
12390;5;"Mixed";34;31;65
12420;3;"Negative";5;25;30
12430;4;"Mostly Negative";13;52;65
12440;5;"Mixed";10;13;23
12450;5;"Mixed";9;7;16
12460;5;"Mixed";41;32;73
12470;5;"Mixed";107;52;159
12480;5;"Mixed";32;41;73
12500;8;"Very Positive";410;62;472
12510;2;"Very Negative";15;81;96
12520;6;"Mostly Positive";157;54;211
12530;6;"Mostly Positive";19;5;24
12540;7;"Positive";9;1;10
12550;5;"Mixed";4;6;10
12560;5;"Mixed";11;16;27
12570;0;"5 user reviews";4;1;5
12580;0;"2 user reviews";1;1;2
12590;5;"Mixed";20;12;32
12600;3;"Negative";3;18;21
12630;0;"7 user reviews";4;3;7
12640;6;"Mostly Positive";114;36;150
12650;0;"2 user reviews";0;2;2
12660;0;"4 user reviews";3;1;4
12670;0;"5 user reviews";2;3;5
12690;6;"Mostly Positive";80;21;101
12710;8;"Very Positive";471;39;510
12750;8;"Very Positive";964;151;1115
12770;6;"Mostly Positive";87;34;121
12790;5;"Mixed";51;55;106
12800;8;"Very Positive";75;6;81
12810;8;"Very Positive";946;193;1139
12830;5;"Mixed";364;225;589
12840;8;"Very Positive";244;13;257
12860;0;"2 user reviews";2;0;2
12900;9;"Overwhelmingly Positive";5176;235;5411
13000;7;"Positive";34;3;37
13140;0;"7 user reviews";3;4;7
13200;5;"Mixed";131;65;196
13210;8;"Very Positive";926;148;1074
13230;9;"Overwhelmingly Positive";1574;44;1618
13240;9;"Overwhelmingly Positive";1570;46;1616
13250;8;"Very Positive";579;36;615
13500;8;"Very Positive";404;90;494
13510;5;"Mixed";51;29;80
13520;6;"Mostly Positive";1653;465;2118
13530;6;"Mostly Positive";234;89;323
13540;6;"Mostly Positive";259;81;340
13560;8;"Very Positive";727;110;837
13570;8;"Very Positive";1547;124;1671
13580;4;"Mostly Negative";182;370;552
13600;8;"Very Positive";627;116;743
13620;7;"Positive";35;2;37
13630;7;"Positive";36;4;40
13640;5;"Mixed";29;31;60
13700;7;"Positive";10;2;12
15000;5;"Mixed";64;60;124
15060;0;"2 user reviews";2;0;2
15080;6;"Mostly Positive";175;46;221
15100;8;"Very Positive";3124;756;3880
15120;8;"Very Positive";1840;296;2136
15130;8;"Very Positive";1045;190;1235
15140;0;"4 user reviews";1;3;4
15150;7;"Positive";37;8;45
15160;5;"Mixed";34;16;50
15170;8;"Very Positive";557;110;667
15190;8;"Very Positive";421;79;500
15200;6;"Mostly Positive";258;105;363
15210;8;"Very Positive";660;118;778
15220;5;"Mixed";10;12;22
15240;8;"Very Positive";84;14;98
15260;0;"2 user reviews";2;0;2
15270;8;"Very Positive";167;35;202
15290;0;"2 user reviews";1;1;2
15300;8;"Very Positive";499;27;526
15310;6;"Mostly Positive";55;22;77
15320;8;"Very Positive";970;110;1080
15350;0;"5 user reviews";3;2;5
15370;8;"Very Positive";368;33;401
15380;8;"Very Positive";44;10;54
15390;8;"Very Positive";572;72;644
15400;6;"Mostly Positive";61;17;78
15500;6;"Mostly Positive";284;91;375
15520;8;"Very Positive";424;84;508
15522;0;"4 user reviews";2;2;4
15540;4;"Mostly Negative";111;289;400
15560;8;"Very Positive";309;52;361
15620;8;"Very Positive";2095;327;2422
15700;8;"Very Positive";883;86;969
15710;9;"Overwhelmingly Positive";547;22;569
15740;6;"Mostly Positive";387;120;507
15750;8;"Very Positive";650;103;753
15800;0;"2 user reviews";1;1;2
15900;6;"Mostly Positive";12;4;16
15910;0;"8 user reviews";6;2;8
15920;3;"Negative";2;10;12
15930;7;"Positive";21;2;23
15940;0;"2 user reviews";2;0;2
15960;5;"Mixed";8;5;13
15970;5;"Mixed";13;8;21
15990;0;"5 user reviews";5;0;5
16000;0;"5 user reviews";2;3;5
16020;0;"7 user reviews";5;2;7
16030;7;"Positive";10;1;11
16040;5;"Mixed";8;5;13
16060;5;"Mixed";7;6;13
16100;7;"Positive";30;7;37
16110;7;"Positive";19;2;21
16120;8;"Very Positive";52;5;57
16130;7;"Positive";36;5;41
16180;7;"Positive";41;8;49
16200;6;"Mostly Positive";20;6;26
16300;8;"Very Positive";80;7;87
16450;8;"Very Positive";1114;243;1357
16465;5;"Mixed";45;22;67
16500;0;"8 user reviews";6;2;8
16600;8;"Very Positive";116;28;144
16620;5;"Mixed";18;12;30
16700;8;"Very Positive";90;5;95
16710;6;"Mostly Positive";115;49;164
16720;5;"Mixed";471;363;834
16730;5;"Mixed";503;440;943
16810;8;"Very Positive";343;60;403
16860;5;"Mixed";13;10;23
16861;5;"Mixed";15;7;22
16862;5;"Mixed";15;11;26
16863;6;"Mostly Positive";14;4;18
16866;7;"Positive";21;5;26
16867;7;"Positive";29;6;35
16868;8;"Very Positive";48;5;53
16870;8;"Very Positive";157;19;176
16900;8;"Very Positive";1002;167;1169
17020;6;"Mostly Positive";207;66;273
17080;5;"Mixed";24;17;41
17095;7;"Positive";11;0;11
17097;5;"Mixed";6;9;15
17100;8;"Very Positive";164;34;198
17120;8;"Very Positive";54;12;66
17140;6;"Mostly Positive";86;28;114
17180;7;"Positive";16;4;20
17300;8;"Very Positive";3385;826;4211
17330;8;"Very Positive";803;163;966
17340;0;"7 user reviews";7;0;7
17390;8;"Very Positive";12620;1513;14133
17400;0;"1 user reviews";1;0;1
17410;8;"Very Positive";8587;1349;9936
17420;0;"5 user reviews";4;1;5
17430;5;"Mixed";1247;577;1824
17440;8;"Very Positive";411;72;483
17450;8;"Very Positive";2257;205;2462
17460;8;"Very Positive";7709;466;8175
17470;8;"Very Positive";5040;646;5686
17480;8;"Very Positive";2177;532;2709
17500;7;"Positive";23;3;26
17510;7;"Positive";12;2;14
17520;7;"Positive";36;3;39
17530;0;"1 user reviews";1;0;1
17550;0;"4 user reviews";4;0;4
17570;8;"Very Positive";50;3;53
17580;0;"1 user reviews";1;0;1
17700;6;"Mostly Positive";10;3;13
17710;6;"Mostly Positive";680;189;869
17730;0;"1 user reviews";1;0;1
17740;6;"Mostly Positive";11;3;14
18000;8;"Very Positive";249;22;271
18020;8;"Very Positive";85;14;99
18040;8;"Very Positive";261;17;278
18050;8;"Very Positive";62;10;72
18070;6;"Mostly Positive";66;21;87
18080;0;"3 user reviews";3;0;3
18110;8;"Very Positive";213;26;239
18120;6;"Mostly Positive";90;30;120
18300;6;"Mostly Positive";166;53;219
18400;5;"Mixed";35;26;61
18407;0;"4 user reviews";2;2;4
18408;0;"2 user reviews";1;1;2
18420;7;"Positive";33;6;39
18450;0;"2 user reviews";2;0;2
18460;0;"2 user reviews";2;0;2
18470;5;"Mixed";19;9;28
18480;5;"Mixed";12;8;20
18490;7;"Positive";38;7;45
18500;9;"Overwhelmingly Positive";2441;76;2517
18508;0;"4 user reviews";4;0;4
18509;0;"1 user reviews";1;0;1
18520;0;"2 user reviews";1;1;2
18521;0;"1 user reviews";1;0;1
18522;7;"Positive";21;1;22
18523;0;"7 user reviews";7;0;7
18600;7;"Positive";8;2;10
18700;6;"Mostly Positive";122;47;169
18820;8;"Very Positive";135;33;168
19000;5;"Mixed";200;225;425
19020;5;"Mixed";8;5;13
19030;5;"Mixed";47;21;68
19080;0;"7 user reviews";1;6;7
19090;7;"Positive";10;0;10
19200;6;"Mostly Positive";135;52;187
19320;0;"3 user reviews";2;1;3
19500;3;"Negative";4;38;42
19680;8;"Very Positive";3107;488;3595
19800;8;"Very Positive";224;43;267
19810;7;"Positive";18;3;21
19830;8;"Very Positive";648;52;700
19900;6;"Mostly Positive";3774;1105;4879
19930;6;"Mostly Positive";88;33;121
19980;6;"Mostly Positive";610;172;782
20200;0;"7 user reviews";1;6;7
20500;8;"Very Positive";3220;316;3536
20510;8;"Very Positive";1856;408;2264
20530;8;"Very Positive";851;128;979
20540;8;"Very Positive";565;34;599
20550;5;"Mixed";200;189;389
20570;8;"Very Positive";551;61;612
20590;7;"Positive";14;0;14
20700;8;"Very Positive";47;11;58
20710;8;"Very Positive";47;9;56
20820;8;"Very Positive";344;14;358
20828;0;"7 user reviews";7;0;7
20840;7;"Positive";10;0;10
20900;8;"Very Positive";14028;2509;16537
20902;0;"1 user reviews";1;0;1
20920;8;"Very Positive";15609;2185;17794
21000;8;"Very Positive";831;183;1014
21010;5;"Mixed";100;59;159
21030;5;"Mixed";35;19;54
21070;0;"2 user reviews";1;1;2
21080;0;"3 user reviews";2;1;3
21090;8;"Very Positive";3366;211;3577
21100;5;"Mixed";1101;648;1749
21110;8;"Very Positive";94;15;109
21120;8;"Very Positive";56;8;64
21130;6;"Mostly Positive";1017;275;1292
21140;0;"2 user reviews";2;0;2
21170;8;"Very Positive";129;19;148
21200;0;"3 user reviews";3;0;3
21201;0;"1 user reviews";1;0;1
21204;0;"1 user reviews";1;0;1
21209;0;"1 user reviews";1;0;1
21210;0;"1 user reviews";1;0;1
21212;0;"1 user reviews";1;0;1
21213;0;"1 user reviews";1;0;1
21214;0;"1 user reviews";1;0;1
21215;0;"1 user reviews";1;0;1
21222;0;"1 user reviews";1;0;1
21300;7;"Positive";17;4;21
21400;0;"3 user reviews";2;1;3
21500;0;"6 user reviews";3;3;6
21600;4;"Mostly Negative";51;94;145
21610;0;"2 user reviews";2;0;2
21620;0;"1 user reviews";0;1;1
21640;6;"Mostly Positive";45;14;59
21660;5;"Mixed";182;87;269
21670;6;"Mostly Positive";303;117;420
21680;6;"Mostly Positive";266;101;367
21690;8;"Very Positive";3817;756;4573
21730;5;"Mixed";7;4;11
21750;0;"1 user reviews";1;0;1
21760;6;"Mostly Positive";286;105;391
21780;8;"Very Positive";227;35;262
21800;6;"Mostly Positive";231;71;302
21900;6;"Mostly Positive";79;28;107
21910;8;"Very Positive";294;50;344
21920;0;"1 user reviews";1;0;1
21950;0;"1 user reviews";1;0;1
21970;8;"Very Positive";787;75;862
21980;6;"Mostly Positive";625;159;784
21990;0;"1 user reviews";1;0;1
21995;0;"5 user reviews";4;1;5
21996;7;"Positive";9;2;11
22000;8;"Very Positive";1573;136;1709
22100;8;"Very Positive";1482;137;1619
22120;8;"Very Positive";942;64;1006
22130;8;"Very Positive";153;34;187
22140;5;"Mixed";167;162;329
22180;8;"Very Positive";1061;134;1195
22200;8;"Very Positive";987;136;1123
22230;8;"Very Positive";1350;113;1463
22300;6;"Mostly Positive";4970;1476;6446
22310;6;"Mostly Positive";334;127;461
22320;9;"Overwhelmingly Positive";8513;435;8948
22330;9;"Overwhelmingly Positive";14815;669;15484
22340;5;"Mixed";750;424;1174
22350;5;"Mixed";748;589;1337
22361;0;"6 user reviews";5;1;6
22363;0;"7 user reviews";7;0;7
22364;0;"7 user reviews";7;0;7
22370;6;"Mostly Positive";12097;3423;15520
22380;9;"Overwhelmingly Positive";63997;2416;66413
22400;7;"Positive";31;5;36
22410;8;"Very Positive";54;13;67
22420;7;"Positive";24;3;27
22430;6;"Mostly Positive";24;10;34
22440;7;"Positive";28;6;34
22450;5;"Mixed";261;114;375
22470;8;"Very Positive";279;45;324
22490;6;"Mostly Positive";618;261;879
22500;8;"Very Positive";96;15;111
22510;0;"1 user reviews";0;1;1
22520;0;"1 user reviews";0;1;1
22521;0;"1 user reviews";1;0;1
22600;8;"Very Positive";1043;223;1266
22610;6;"Mostly Positive";241;82;323
22630;0;"5 user reviews";4;1;5
22631;0;"6 user reviews";4;2;6
22632;0;"6 user reviews";5;1;6
22633;0;"5 user reviews";4;1;5
22634;0;"4 user reviews";4;0;4
22650;6;"Mostly Positive";80;30;110
22670;5;"Mixed";74;33;107
22803;0;"1 user reviews";1;0;1
22813;0;"1 user reviews";1;0;1
22815;0;"1 user reviews";1;0;1
22821;0;"1 user reviews";1;0;1
22845;0;"1 user reviews";1;0;1
23100;0;"3 user reviews";2;1;3
23120;8;"Very Positive";68;14;82
23130;0;"3 user reviews";3;0;3
23140;7;"Positive";14;1;15
23150;6;"Mostly Positive";7;3;10
23200;5;"Mixed";36;20;56
23300;6;"Mostly Positive";31;10;41
23310;6;"Mostly Positive";1268;333;1601
23380;5;"Mixed";70;41;111
23390;0;"9 user reviews";8;1;9
23400;8;"Very Positive";81;20;101
23420;5;"Mixed";77;45;122
23450;6;"Mostly Positive";204;72;276
23460;6;"Mostly Positive";54;15;69
23490;8;"Very Positive";329;37;366
23500;5;"Mixed";89;115;204
23510;0;"4 user reviews";4;0;4
23530;8;"Very Positive";457;60;517
23600;8;"Very Positive";48;10;58
23700;5;"Mixed";45;27;72
24010;5;"Mixed";4800;2337;7137
24012;4;"Mostly Negative";5;10;15
24021;8;"Very Positive";45;6;51
24028;0;"4 user reviews";1;3;4
24029;6;"Mostly Positive";9;3;12
24036;5;"Mixed";8;9;17
24055;5;"Mixed";7;4;11
24065;5;"Mixed";11;16;27
24070;0;"4 user reviews";3;1;4
24075;0;"9 user reviews";8;1;9
24081;0;"1 user reviews";1;0;1
24082;6;"Mostly Positive";11;4;15
24083;5;"Mixed";34;22;56
24095;7;"Positive";19;4;23
24096;7;"Positive";21;5;26
24110;0;"1 user reviews";1;0;1
24120;0;"1 user reviews";1;0;1
24150;0;"3 user reviews";3;0;3
24170;0;"7 user reviews";6;1;7
24200;5;"Mixed";72;39;111
24220;0;"2 user reviews";1;1;2
24240;8;"Very Positive";6624;582;7206
24400;5;"Mixed";176;82;258
24410;5;"Mixed";8;8;16
24420;8;"Very Positive";320;36;356
24440;0;"3 user reviews";1;2;3
24441;0;"2 user reviews";1;1;2
24447;0;"3 user reviews";2;1;3
24449;0;"5 user reviews";2;3;5
24460;4;"Mostly Negative";6;11;17
24470;5;"Mixed";20;10;30
24480;5;"Mixed";95;84;179
24488;0;"7 user reviews";6;1;7
24500;6;"Mostly Positive";26;10;36
24600;0;"1 user reviews";1;0;1
24630;0;"1 user reviews";1;0;1
24640;0;"8 user reviews";3;5;8
24650;5;"Mixed";10;6;16
24660;5;"Mixed";7;4;11
24670;5;"Mixed";346;149;495
24676;0;"1 user reviews";1;0;1
24677;0;"1 user reviews";1;0;1
24679;0;"1 user reviews";0;1;1
24700;0;"1 user reviews";1;0;1
24720;8;"Very Positive";1482;217;1699
24780;6;"Mostly Positive";2379;684;3063
24790;8;"Very Positive";1588;219;1807
24800;8;"Very Positive";534;94;628
24810;8;"Very Positive";844;50;894
24840;6;"Mostly Positive";998;266;1264
24850;0;"1 user reviews";1;0;1
24860;8;"Very Positive";846;84;930
24870;5;"Mixed";438;220;658
24960;8;"Very Positive";9245;1492;10737
24963;8;"Very Positive";60;12;72
24980;8;"Very Positive";7294;457;7751
25000;6;"Mostly Positive";2210;592;2802
25010;8;"Very Positive";141;20;161
25500;5;"Mixed";32;45;77
25600;8;"Very Positive";73;14;87
25620;7;"Positive";38;7;45
25700;8;"Very Positive";111;18;129
25758;0;"1 user reviews";1;0;1
25759;0;"1 user reviews";1;0;1
25800;8;"Very Positive";677;99;776
25806;7;"Positive";13;1;14
25808;7;"Positive";16;0;16
25809;0;"2 user reviews";1;1;2
25810;0;"2 user reviews";1;1;2
25811;0;"3 user reviews";2;1;3
25812;0;"5 user reviews";2;3;5
25813;0;"5 user reviews";2;3;5
25814;0;"3 user reviews";2;1;3
25815;0;"2 user reviews";1;1;2
25816;0;"2 user reviews";2;0;2
25817;0;"2 user reviews";1;1;2
25830;8;"Very Positive";679;63;742
25840;0;"2 user reviews";2;0;2
25850;6;"Mostly Positive";39;13;52
25860;0;"2 user reviews";1;1;2
25890;6;"Mostly Positive";1817;516;2333
25892;0;"4 user reviews";1;3;4
25896;0;"4 user reviews";1;3;4
25897;0;"4 user reviews";1;3;4
25898;0;"2 user reviews";1;1;2
25899;0;"4 user reviews";2;2;4
25900;8;"Very Positive";502;70;572
25910;8;"Very Positive";101;23;124
25920;0;"3 user reviews";3;0;3
25930;5;"Mixed";41;28;69
25940;0;"1 user reviews";1;0;1
25960;0;"2 user reviews";0;2;2
25962;0;"8 user reviews";5;3;8
25980;5;"Mixed";236;138;374
25990;8;"Very Positive";248;10;258
26000;8;"Very Positive";96;18;114
26005;0;"5 user reviews";3;2;5
26006;0;"2 user reviews";2;0;2
26007;0;"3 user reviews";3;0;3
26300;4;"Mostly Negative";11;20;31
26500;8;"Very Positive";166;21;187
26800;8;"Very Positive";2421;196;2617
26803;0;"2 user reviews";2;0;2
26900;8;"Very Positive";91;10;101
27000;6;"Mostly Positive";301;109;410
27020;5;"Mixed";101;87;188
27050;5;"Mixed";33;34;67
27200;0;"9 user reviews";7;2;9
27220;0;"5 user reviews";5;0;5
27300;7;"Positive";13;3;16
27400;6;"Mostly Positive";65;22;87
27800;6;"Mostly Positive";34;11;45
27810;8;"Very Positive";44;8;52
27900;4;"Mostly Negative";39;67;106
27920;5;"Mixed";39;44;83
27940;4;"Mostly Negative";64;132;196
28000;5;"Mixed";892;577;1469
28010;0;"7 user reviews";6;1;7
28011;0;"7 user reviews";6;1;7
28012;0;"7 user reviews";5;2;7
28050;9;"Overwhelmingly Positive";2822;22;2844
28060;0;"3 user reviews";3;0;3
28061;0;"4 user reviews";4;0;4
29120;0;"5 user reviews";5;0;5
29130;8;"Very Positive";57;6;63
29160;5;"Mixed";58;25;83
29180;8;"Very Positive";248;34;282
29540;0;"5 user reviews";5;0;5
29570;7;"Positive";28;1;29
29600;0;"5 user reviews";5;0;5
29620;7;"Positive";28;1;29
29640;7;"Positive";9;2;11
29650;0;"1 user reviews";0;1;1
29680;0;"6 user reviews";6;0;6
29700;0;"1 user reviews";1;0;1
29720;8;"Very Positive";152;3;155
29800;6;"Mostly Positive";994;282;1276
29900;8;"Very Positive";125;27;152
31100;0;"9 user reviews";8;1;9
31110;0;"2 user reviews";2;0;2
31120;0;"2 user reviews";2;0;2
31130;0;"2 user reviews";2;0;2
31170;8;"Very Positive";243;34;277
31180;7;"Positive";19;3;22
31190;7;"Positive";21;2;23
31200;6;"Mostly Positive";17;5;22
31210;7;"Positive";24;3;27
31220;8;"Very Positive";158;12;170
31230;7;"Positive";14;2;16
31240;7;"Positive";12;1;13
31250;7;"Positive";12;1;13
31260;7;"Positive";14;1;15
31270;8;"Very Positive";738;111;849
31280;8;"Very Positive";3767;566;4333
31290;8;"Very Positive";692;83;775
31300;3;"Negative";4;17;21
31410;8;"Very Positive";201;7;208
31420;0;"3 user reviews";3;0;3
31500;0;"1 user reviews";1;0;1
31700;8;"Very Positive";155;25;180
31800;6;"Mostly Positive";26;10;36
31810;8;"Very Positive";95;6;101
31820;8;"Very Positive";56;7;63
31830;8;"Very Positive";101;9;110
31840;8;"Very Positive";66;7;73
31850;8;"Very Positive";70;5;75
31860;8;"Very Positive";48;6;54
31870;5;"Mixed";14;8;22
31880;8;"Very Positive";62;5;67
31890;8;"Very Positive";47;7;54
31900;6;"Mostly Positive";32;11;43
31910;6;"Mostly Positive";47;12;59
31920;8;"Very Positive";40;10;50
31930;6;"Mostly Positive";45;19;64
32000;3;"Negative";0;13;13
32110;7;"Positive";13;1;14
32120;0;"4 user reviews";2;2;4
32140;6;"Mostly Positive";32;10;42
32150;8;"Very Positive";256;4;260
32160;8;"Very Positive";66;7;73
32200;6;"Mostly Positive";49;18;67
32310;6;"Mostly Positive";86;25;111
32330;8;"Very Positive";345;67;412
32340;8;"Very Positive";248;29;277
32350;5;"Mixed";132;135;267
32360;9;"Overwhelmingly Positive";1538;61;1599
32370;8;"Very Positive";12234;1331;13565
32380;6;"Mostly Positive";619;231;850
32390;5;"Mixed";260;163;423
32400;8;"Very Positive";1074;127;1201
32410;5;"Mixed";18;9;27
32420;4;"Mostly Negative";96;200;296
32430;5;"Mixed";1676;822;2498
32440;9;"Overwhelmingly Positive";5735;251;5986
32450;8;"Very Positive";157;39;196
32460;8;"Very Positive";769;52;821
32469;8;"Very Positive";769;52;821
32470;9;"Overwhelmingly Positive";11115;336;11451
32500;5;"Mixed";1017;883;1900
32510;8;"Very Positive";1187;112;1299
32610;5;"Mixed";33;26;59
32620;8;"Very Positive";153;21;174
32630;8;"Very Positive";122;19;141
32640;8;"Very Positive";74;9;83
32650;5;"Mixed";32;16;48
32660;7;"Positive";26;6;32
32670;8;"Very Positive";143;12;155
32680;8;"Very Positive";116;16;132
32690;0;"7 user reviews";5;2;7
32700;0;"4 user reviews";3;1;4
32710;5;"Mixed";16;13;29
32720;6;"Mostly Positive";26;9;35
32730;5;"Mixed";30;25;55
32740;6;"Mostly Positive";20;8;28
32750;8;"Very Positive";79;10;89
32760;8;"Very Positive";107;11;118
32770;8;"Very Positive";104;9;113
32800;6;"Mostly Positive";996;338;1334
32900;6;"Mostly Positive";81;26;107
33100;8;"Very Positive";190;26;216
33110;6;"Mostly Positive";48;20;68
33120;8;"Very Positive";204;20;224
33130;8;"Very Positive";115;19;134
33180;6;"Mostly Positive";74;20;94
33220;5;"Mixed";840;378;1218
33229;5;"Mixed";840;378;1218
33230;8;"Very Positive";6426;1254;7680
33260;5;"Mixed";6;6;12
33280;7;"Positive";14;0;14
33320;5;"Mixed";322;142;464
33372;7;"Positive";12;3;15
33390;6;"Mostly Positive";10;3;13
33420;5;"Mixed";55;65;120
33460;5;"Mixed";953;608;1561
33520;8;"Very Positive";263;34;297
33530;7;"Positive";28;6;34
33540;4;"Mostly Negative";4;10;14
33550;4;"Mostly Negative";4;10;14
33570;6;"Mostly Positive";200;60;260
33580;5;"Mixed";45;21;66
33600;8;"Very Positive";194;32;226
33610;5;"Mixed";110;78;188
33620;8;"Very Positive";118;21;139
33650;8;"Very Positive";164;26;190
33660;5;"Mixed";11;6;17
33670;5;"Mixed";71;67;138
33680;8;"Very Positive";639;64;703
33710;0;"5 user reviews";4;1;5
33720;7;"Positive";10;1;11
33730;6;"Mostly Positive";41;13;54
33740;0;"3 user reviews";3;0;3
33750;4;"Mostly Negative";5;17;22
33760;0;"5 user reviews";1;4;5
33770;8;"Very Positive";92;23;115
33780;6;"Mostly Positive";10;4;14
33790;0;"9 user reviews";6;3;9
33900;8;"Very Positive";1347;260;1607
33910;5;"Mixed";68;47;115
33930;8;"Very Positive";7720;594;8314
33934;6;"Mostly Positive";49;16;65
33950;7;"Positive";34;2;36
33980;5;"Mixed";37;36;73
33990;5;"Mixed";50;58;108
34000;0;"1 user reviews";1;0;1
34010;8;"Very Positive";1844;361;2205
34030;8;"Very Positive";3874;421;4295
34050;0;"1 user reviews";1;0;1
34174;7;"Positive";20;1;21
34178;7;"Positive";18;2;20
34179;7;"Positive";31;3;34
34180;0;"2 user reviews";1;1;2
34190;8;"Very Positive";413;91;504
34220;7;"Positive";32;0;32
34270;8;"Very Positive";1891;339;2230
34272;0;"6 user reviews";6;0;6
34273;0;"4 user reviews";4;0;4
34274;0;"2 user reviews";2;0;2
34275;0;"3 user reviews";3;0;3
34276;0;"4 user reviews";3;1;4
34277;0;"2 user reviews";2;0;2
34278;0;"6 user reviews";6;0;6
34279;0;"3 user reviews";3;0;3
34280;0;"4 user reviews";4;0;4
34281;0;"3 user reviews";3;0;3
34282;0;"4 user reviews";4;0;4
34283;0;"2 user reviews";1;1;2
34284;0;"3 user reviews";3;0;3
34285;0;"3 user reviews";2;1;3
34286;0;"5 user reviews";5;0;5
34287;0;"3 user reviews";2;1;3
34288;0;"2 user reviews";2;0;2
34289;0;"5 user reviews";5;0;5
34310;0;"2 user reviews";1;1;2
34311;0;"2 user reviews";2;0;2
34312;0;"2 user reviews";2;0;2
34313;0;"5 user reviews";5;0;5
34314;0;"2 user reviews";1;1;2
34315;0;"2 user reviews";2;0;2
34316;0;"2 user reviews";2;0;2
34317;0;"3 user reviews";2;1;3
34318;0;"2 user reviews";2;0;2
34319;0;"2 user reviews";2;0;2
34330;8;"Very Positive";11179;1031;12210
34342;7;"Positive";20;2;22
34343;5;"Mixed";25;13;38
34345;0;"9 user reviews";7;2;9
34348;7;"Positive";15;0;15
34410;8;"Very Positive";99;23;122
34420;5;"Mixed";14;17;31
34440;7;"Positive";23;2;25
34450;0;"5 user reviews";5;0;5
34460;7;"Positive";25;0;25
34500;6;"Mostly Positive";17;5;22
34600;5;"Mixed";76;43;119
34630;0;"9 user reviews";7;2;9
34640;7;"Positive";15;1;16
34650;0;"3 user reviews";3;0;3
34670;0;"1 user reviews";1;0;1
34800;6;"Mostly Positive";20;8;28
34810;6;"Mostly Positive";48;13;61
34820;6;"Mostly Positive";129;35;164
34830;5;"Mixed";564;533;1097
34841;6;"Mostly Positive";9;3;12
34842;7;"Positive";16;0;16
34860;0;"2 user reviews";2;0;2
34870;5;"Mixed";1764;951;2715
34900;8;"Very Positive";4012;993;5005
34910;0;"3 user reviews";2;1;3
34920;2;"Very Negative";12;56;68
35000;8;"Very Positive";605;99;704
35010;0;"3 user reviews";1;2;3
35030;6;"Mostly Positive";21;8;29
35050;0;"2 user reviews";2;0;2
35070;5;"Mixed";46;27;73
35080;5;"Mixed";26;14;40
35083;5;"Mixed";19;14;33
35089;6;"Mostly Positive";13;5;18
35090;7;"Positive";21;4;25
35091;7;"Positive";37;3;40
35101;7;"Positive";36;9;45
35102;7;"Positive";34;4;38
35110;0;"1 user reviews";1;0;1
35130;8;"Very Positive";1062;93;1155
35135;7;"Positive";9;2;11
35136;7;"Positive";8;2;10
35137;0;"6 user reviews";3;3;6
35138;0;"6 user reviews";3;3;6
35140;9;"Overwhelmingly Positive";8198;373;8571
35300;5;"Mixed";22;11;33
35310;7;"Positive";26;5;31
35320;6;"Mostly Positive";48;17;65
35417;7;"Positive";12;1;13
35419;7;"Positive";14;2;16
35420;5;"Mixed";102;143;245
35425;7;"Positive";12;1;13
35429;0;"4 user reviews";3;1;4
35450;8;"Very Positive";9713;602;10315
35460;6;"Mostly Positive";338;105;443
35480;6;"Mostly Positive";293;84;377
35500;5;"Mixed";12;9;21
35510;5;"Mixed";6;4;10
35600;5;"Mixed";29;29;58
35700;8;"Very Positive";3276;189;3465
35720;9;"Overwhelmingly Positive";4695;231;4926
35725;7;"Positive";9;1;10
35800;8;"Very Positive";44;7;51
36000;5;"Mixed";92;68;160
36100;8;"Very Positive";52;1;53
36110;0;"6 user reviews";6;0;6
36120;0;"7 user reviews";7;0;7
36130;0;"5 user reviews";4;1;5
36140;0;"5 user reviews";3;2;5
36150;7;"Positive";10;0;10
36160;0;"2 user reviews";2;0;2
36170;0;"1 user reviews";1;0;1
36180;5;"Mixed";28;15;43
36190;0;"3 user reviews";2;1;3
36200;0;"2 user reviews";1;1;2
36210;6;"Mostly Positive";11;3;14
36240;0;"7 user reviews";6;1;7
36270;6;"Mostly Positive";8;3;11
36280;0;"2 user reviews";2;0;2
36290;0;"1 user reviews";1;0;1
36300;6;"Mostly Positive";14;4;18
36310;7;"Positive";14;1;15
36320;0;"5 user reviews";1;4;5
36700;6;"Mostly Positive";12;4;16
36900;0;"3 user reviews";0;3;3
36910;3;"Negative";2;9;11
37000;8;"Very Positive";364;79;443
37010;5;"Mixed";51;43;94
37030;6;"Mostly Positive";70;19;89
37100;6;"Mostly Positive";45;19;64
37200;0;"6 user reviews";5;1;6
37210;5;"Mixed";51;35;86
37220;6;"Mostly Positive";30;10;40
37230;0;"7 user reviews";3;4;7
37240;4;"Mostly Negative";28;71;99
37250;0;"1 user reviews";1;0;1
37260;8;"Very Positive";48;3;51
37270;7;"Positive";17;1;18
37280;6;"Mostly Positive";11;4;15
37290;0;"6 user reviews";5;1;6
37300;5;"Mixed";8;6;14
37310;4;"Mostly Negative";4;9;13
37320;0;"5 user reviews";2;3;5
37330;0;"3 user reviews";3;0;3
37340;0;"6 user reviews";5;1;6
37350;0;"2 user reviews";2;0;2
37360;0;"5 user reviews";3;2;5
37370;0;"4 user reviews";3;1;4
37380;0;"7 user reviews";3;4;7
37390;7;"Positive";15;1;16
37400;8;"Very Positive";308;44;352
37420;5;"Mixed";7;4;11
37500;6;"Mostly Positive";17;7;24
37600;8;"Very Positive";372;34;406
37700;6;"Mostly Positive";140;54;194
37800;5;"Mixed";23;10;33
37900;0;"2 user reviews";2;0;2
37920;0;"1 user reviews";1;0;1
37940;0;"1 user reviews";1;0;1
37960;7;"Positive";18;3;21
37970;0;"6 user reviews";6;0;6
37980;0;"5 user reviews";5;0;5
37990;0;"2 user reviews";2;0;2
38000;7;"Positive";17;3;20
38020;0;"3 user reviews";3;0;3
38050;0;"1 user reviews";1;0;1
38060;0;"3 user reviews";3;0;3
38070;0;"7 user reviews";7;0;7
38080;7;"Positive";16;1;17
38090;0;"4 user reviews";4;0;4
38100;0;"2 user reviews";2;0;2
38110;0;"6 user reviews";4;2;6
38120;0;"9 user reviews";8;1;9
38130;7;"Positive";17;1;18
38140;0;"5 user reviews";5;0;5
38150;0;"3 user reviews";2;1;3
38160;0;"1 user reviews";1;0;1
38170;7;"Positive";13;1;14
38180;0;"1 user reviews";1;0;1
38185;7;"Positive";26;2;28
38190;0;"5 user reviews";3;2;5
38200;0;"1 user reviews";1;0;1
38210;6;"Mostly Positive";98;29;127
38220;5;"Mixed";40;20;60
38230;5;"Mixed";38;50;88
38240;0;"5 user reviews";3;2;5
38400;8;"Very Positive";4062;279;4341
38410;8;"Very Positive";3488;244;3732
38420;8;"Very Positive";664;161;825
38430;6;"Mostly Positive";134;37;171
38440;8;"Very Positive";273;25;298
38450;6;"Mostly Positive";97;28;125
38460;6;"Mostly Positive";57;16;73
38480;4;"Mostly Negative";23;40;63
38490;5;"Mixed";24;17;41
38530;0;"9 user reviews";9;0;9
38600;8;"Very Positive";763;77;840
38700;8;"Very Positive";578;92;670
38720;8;"Very Positive";441;56;497
38740;8;"Very Positive";687;61;748
38830;5;"Mixed";10;10;20
38900;5;"Mixed";41;42;83
38924;0;"1 user reviews";1;0;1
39000;8;"Very Positive";125;21;146
39110;6;"Mostly Positive";96;26;122
39120;6;"Mostly Positive";542;189;731
39140;8;"Very Positive";8956;814;9770
39150;8;"Very Positive";3023;496;3519
39160;5;"Mixed";467;418;885
39190;6;"Mostly Positive";911;290;1201
39200;5;"Mixed";519;234;753
39210;8;"Very Positive";16716;2265;18981
39250;7;"Positive";24;2;26
39260;7;"Positive";10;0;10
39270;7;"Positive";21;1;22
39500;5;"Mixed";739;364;1103
39510;8;"Very Positive";962;203;1165
39520;5;"Mixed";75;51;126
39530;8;"Very Positive";261;43;304
39540;6;"Mostly Positive";342;100;442
39550;5;"Mixed";157;101;258
39560;4;"Mostly Negative";34;80;114
39610;0;"1 user reviews";1;0;1
39630;5;"Mixed";64;28;92
39640;6;"Mostly Positive";44;16;60
39650;5;"Mixed";155;84;239
39660;5;"Mixed";48;28;76
39670;6;"Mostly Positive";266;104;370
39680;6;"Mostly Positive";1028;274;1302
39690;5;"Mixed";257;225;482
39710;0;"7 user reviews";5;2;7
39800;8;"Very Positive";980;105;1085
39900;5;"Mixed";10;5;15
40000;7;"Positive";12;0;12
40100;8;"Very Positive";2560;453;3013
40135;8;"Very Positive";130;9;139
40200;0;"9 user reviews";6;3;9
40210;0;"6 user reviews";6;0;6
40300;8;"Very Positive";1090;251;1341
40320;7;"Positive";37;6;43
40330;8;"Very Positive";57;13;70
40340;6;"Mostly Positive";30;12;42
40350;8;"Very Positive";113;17;130
40370;0;"3 user reviews";3;0;3
40380;6;"Mostly Positive";243;73;316
40390;6;"Mostly Positive";485;168;653
40391;0;"8 user reviews";5;3;8
40392;0;"8 user reviews";7;1;8
40393;0;"7 user reviews";5;2;7
40400;8;"Very Positive";678;98;776
40403;0;"3 user reviews";3;0;3
40406;0;"4 user reviews";3;1;4
40407;0;"5 user reviews";5;0;5
40408;0;"3 user reviews";3;0;3
40420;6;"Mostly Positive";48;18;66
40500;4;"Mostly Negative";5;9;14
40700;8;"Very Positive";2077;120;2197
40703;0;"9 user reviews";8;1;9
40720;8;"Very Positive";241;53;294
40800;8;"Very Positive";8970;540;9510
40920;0;"4 user reviews";2;2;4
40930;8;"Very Positive";204;31;235
40940;4;"Mostly Negative";82;186;268
40950;8;"Very Positive";1444;103;1547
40960;8;"Very Positive";704;103;807
40970;9;"Overwhelmingly Positive";2267;82;2349
40980;8;"Very Positive";307;68;375
40990;8;"Very Positive";930;140;1070
41000;8;"Very Positive";1506;128;1634
41010;8;"Very Positive";460;21;481
41014;8;"Very Positive";57;7;64
41019;0;"7 user reviews";4;3;7
41050;9;"Overwhelmingly Positive";610;31;641
41060;8;"Very Positive";255;18;273
41070;8;"Very Positive";3998;594;4592
41074;6;"Mostly Positive";54;16;70
41100;8;"Very Positive";190;25;215
41210;8;"Very Positive";333;25;358
41300;8;"Very Positive";441;24;465
41400;4;"Mostly Negative";5;12;17
41500;8;"Very Positive";2289;190;2479
41600;5;"Mixed";30;34;64
41660;0;"7 user reviews";3;4;7
41680;0;"7 user reviews";1;6;7
41700;9;"Overwhelmingly Positive";5076;252;5328
41730;6;"Mostly Positive";35;10;45
41740;8;"Very Positive";127;27;154
41800;8;"Very Positive";313;73;386
41802;0;"1 user reviews";1;0;1
41803;0;"1 user reviews";1;0;1
41804;0;"1 user reviews";1;0;1
41814;0;"1 user reviews";0;1;1
41816;0;"2 user reviews";1;1;2
41817;0;"1 user reviews";1;0;1
41900;6;"Mostly Positive";353;103;456
42000;0;"7 user reviews";4;3;7
42120;6;"Mostly Positive";367;148;515
42140;5;"Mixed";57;35;92
42160;5;"Mixed";587;363;950
42170;5;"Mixed";195;150;345
42200;6;"Mostly Positive";31;8;39
42210;6;"Mostly Positive";83;32;115
42220;8;"Very Positive";75;11;86
42230;5;"Mixed";35;16;51
42500;5;"Mixed";86;54;140
42640;8;"Very Positive";225;4;229
42670;8;"Very Positive";1822;163;1985
42680;8;"Very Positive";2752;560;3312
42690;0;"2 user reviews";1;1;2
42695;0;"8 user reviews";7;1;8
42696;7;"Positive";10;0;10
42697;7;"Positive";10;2;12
42698;0;"5 user reviews";5;0;5
42700;8;"Very Positive";4240;599;4839
42710;8;"Very Positive";291;27;318
42716;7;"Positive";31;7;38
42718;6;"Mostly Positive";40;12;52
42719;8;"Very Positive";135;18;153
42722;6;"Mostly Positive";27;7;34
42730;7;"Positive";16;1;17
42800;0;"1 user reviews";0;1;1
42810;6;"Mostly Positive";39;15;54
42820;0;"2 user reviews";0;2;2
42850;8;"Very Positive";121;23;144
42881;0;"1 user reviews";1;0;1
42890;8;"Very Positive";311;35;346
42900;0;"1 user reviews";1;0;1
42902;0;"1 user reviews";1;0;1
42903;0;"4 user reviews";4;0;4
42904;0;"9 user reviews";4;5;9
42905;0;"1 user reviews";1;0;1
42910;8;"Very Positive";6186;814;7000
42918;8;"Very Positive";47;9;56
42920;4;"Mostly Negative";21;33;54
42930;0;"5 user reviews";4;1;5
42940;0;"7 user reviews";5;2;7
42950;0;"9 user reviews";8;1;9
42960;8;"Very Positive";4595;392;4987
42964;7;"Positive";13;2;15
42965;0;"7 user reviews";6;1;7
42966;5;"Mixed";6;4;10
42967;0;"2 user reviews";2;0;2
42968;6;"Mostly Positive";26;9;35
42980;6;"Mostly Positive";60;23;83
42990;4;"Mostly Negative";174;290;464
43000;5;"Mixed";191;137;328
43005;0;"2 user reviews";0;2;2
43006;0;"2 user reviews";0;2;2
43011;0;"1 user reviews";0;1;1
43013;0;"2 user reviews";1;1;2
43014;0;"2 user reviews";1;1;2
43100;6;"Mostly Positive";69;20;89
43110;8;"Very Positive";2736;207;2943
43160;8;"Very Positive";3792;277;4069
43190;8;"Very Positive";183;33;216
43500;4;"Mostly Negative";24;49;73
43600;8;"Very Positive";85;12;97
44100;8;"Very Positive";53;10;63
44320;5;"Mixed";626;321;947
44340;5;"Mixed";230;189;419
44350;6;"Mostly Positive";2069;676;2745
44360;5;"Mixed";104;46;150
44600;5;"Mixed";18;14;32
44620;0;"3 user reviews";3;0;3
44650;0;"7 user reviews";5;2;7
44660;7;"Positive";9;1;10
44670;0;"5 user reviews";5;0;5
44680;0;"2 user reviews";2;0;2
44690;8;"Very Positive";78;13;91
45000;8;"Very Positive";193;12;205
45100;8;"Very Positive";433;90;523
45200;7;"Positive";11;0;11
45300;5;"Mixed";198;108;306
45302;4;"Mostly Negative";4;8;12
45400;8;"Very Positive";290;23;313
45410;5;"Mixed";23;23;46
45420;0;"1 user reviews";0;1;1
45450;8;"Very Positive";131;12;143
45700;8;"Very Positive";681;79;760
45710;5;"Mixed";136;128;264
45720;5;"Mixed";80;64;144
45730;5;"Mixed";63;82;145
45740;6;"Mostly Positive";1366;435;1801
45750;5;"Mixed";724;352;1076
45760;8;"Very Positive";3132;401;3533
45770;8;"Very Positive";721;166;887
45773;5;"Mixed";11;15;26
45774;4;"Mostly Negative";4;11;15
45775;4;"Mostly Negative";6;18;24
45776;4;"Mostly Negative";7;14;21
45790;0;"2 user reviews";1;1;2
45791;0;"2 user reviews";2;0;2
45792;0;"1 user reviews";1;0;1
45793;0;"2 user reviews";2;0;2
45795;0;"2 user reviews";1;1;2
45796;0;"2 user reviews";1;1;2
45797;0;"1 user reviews";1;0;1
45900;3;"Negative";2;11;13
46000;5;"Mixed";46;22;68
46200;5;"Mixed";11;10;21
46210;0;"2 user reviews";2;0;2
46220;0;"2 user reviews";1;1;2
46230;0;"7 user reviews";3;4;7
46250;6;"Mostly Positive";74;26;100
46260;6;"Mostly Positive";86;34;120
46270;5;"Mixed";59;32;91
46280;4;"Mostly Negative";11;28;39
46290;5;"Mixed";47;42;89
46320;0;"1 user reviews";1;0;1
46330;7;"Positive";45;0;45
46340;5;"Mixed";39;19;58
46342;0;"2 user reviews";1;1;2
46350;5;"Mixed";10;15;25
46360;5;"Mixed";32;20;52
46370;5;"Mixed";65;53;118
46380;5;"Mixed";14;21;35
46400;5;"Mixed";44;64;108
46410;5;"Mixed";75;35;110
46420;5;"Mixed";83;48;131
46430;6;"Mostly Positive";36;14;50
46440;4;"Mostly Negative";40;93;133
46450;5;"Mixed";103;91;194
46460;8;"Very Positive";177;33;210
46480;8;"Very Positive";227;48;275
46490;5;"Mixed";67;85;152
46500;8;"Very Positive";699;132;831
46510;8;"Very Positive";277;54;331
46520;5;"Mixed";42;31;73
46540;4;"Mostly Negative";85;158;243
46550;5;"Mixed";49;53;102
46560;5;"Mixed";176;140;316
46570;5;"Mixed";40;52;92
46600;6;"Mostly Positive";26;9;35
46700;4;"Mostly Negative";4;16;20
46710;5;"Mixed";9;10;19
46720;4;"Mostly Negative";3;9;12
46730;4;"Mostly Negative";9;28;37
46740;4;"Mostly Negative";10;32;42
46750;5;"Mixed";74;49;123
46760;0;"5 user reviews";2;3;5
46770;8;"Very Positive";147;34;181
46790;5;"Mixed";18;12;30
46830;0;"9 user reviews";4;5;9
46840;0;"2 user reviews";0;2;2
46850;6;"Mostly Positive";17;7;24
47000;8;"Very Positive";259;51;310
47110;0;"7 user reviews";5;2;7
47120;0;"1 user reviews";1;0;1
47130;0;"7 user reviews";6;1;7
47400;4;"Mostly Negative";306;1009;1315
47410;5;"Mixed";52;28;80
47500;0;"9 user reviews";7;2;9
47520;0;"3 user reviews";2;1;3
47540;8;"Very Positive";183;42;225
47570;0;"2 user reviews";2;0;2
47700;1;"Overwhelmingly Negative";205;1274;1479
47730;7;"Positive";41;2;43
47780;8;"Very Positive";4734;275;5009
47790;6;"Mostly Positive";790;242;1032
47810;8;"Very Positive";8631;824;9455
47830;7;"Positive";10;1;11
47850;0;"1 user reviews";0;1;1
47870;6;"Mostly Positive";3597;1113;4710
47880;8;"Very Positive";149;2;151
47890;8;"Very Positive";10834;1850;12684
47892;6;"Mostly Positive";37;10;47
47893;7;"Positive";35;3;38
47894;8;"Very Positive";51;7;58
47895;5;"Mixed";6;5;11
47896;6;"Mostly Positive";8;3;11
47897;0;"8 user reviews";7;1;8
47898;8;"Very Positive";41;9;50
47899;5;"Mixed";5;7;12
47900;8;"Very Positive";120;12;132
47920;5;"Mixed";493;368;861
47930;8;"Very Positive";162;36;198
47931;7;"Positive";10;2;12
47932;5;"Mixed";18;13;31
48000;8;"Very Positive";6610;518;7128
48110;4;"Mostly Negative";424;642;1066
48120;5;"Mixed";30;29;59
48150;0;"4 user reviews";4;0;4
48160;4;"Mostly Negative";48;83;131
48167;0;"1 user reviews";1;0;1
48180;4;"Mostly Negative";48;83;131
48187;0;"1 user reviews";0;1;1
48190;8;"Very Positive";3192;510;3702
48220;4;"Mostly Negative";1086;1836;2922
48231;0;"5 user reviews";1;4;5
48232;0;"3 user reviews";1;2;3
48240;5;"Mixed";3152;2607;5759
48700;9;"Overwhelmingly Positive";43749;1009;44758
48705;8;"Very Positive";1487;151;1638
48720;8;"Very Positive";2109;489;2598
48800;5;"Mixed";356;405;761
48802;0;"5 user reviews";5;0;5
48803;6;"Mostly Positive";13;5;18
48804;0;"3 user reviews";2;1;3
48805;0;"5 user reviews";3;2;5
48806;6;"Mostly Positive";10;3;13
48900;7;"Positive";33;4;37
48950;8;"Very Positive";211;30;241
49000;6;"Mostly Positive";25;10;35
49300;5;"Mixed";33;41;74
49310;0;"2 user reviews";2;0;2
49311;0;"4 user reviews";4;0;4
49320;5;"Mixed";20;12;32
49330;5;"Mixed";44;27;71
49337;0;"2 user reviews";1;1;2
49400;8;"Very Positive";80;3;83
49470;8;"Very Positive";493;72;565
49473;0;"3 user reviews";3;0;3
49474;0;"2 user reviews";2;0;2
49475;0;"4 user reviews";2;2;4
49476;0;"3 user reviews";2;1;3
49490;0;"1 user reviews";1;0;1
49491;0;"1 user reviews";1;0;1
49492;0;"1 user reviews";1;0;1
49493;0;"1 user reviews";1;0;1
49494;0;"1 user reviews";1;0;1
49495;0;"1 user reviews";1;0;1
49496;0;"1 user reviews";1;0;1
49497;0;"1 user reviews";1;0;1
49498;0;"1 user reviews";1;0;1
49499;0;"1 user reviews";1;0;1
49520;9;"Overwhelmingly Positive";81948;3388;85336
49540;5;"Mixed";1463;1430;2893
49600;9;"Overwhelmingly Positive";3107;161;3268
49604;8;"Very Positive";53;4;57
49700;0;"2 user reviews";1;1;2
